############################################
#   ..     #       ..  .# ................ #
#  ....    #  ..   ..  .# .    ####      . #
#  ....    #           .# ....... #      . #
#   ..     # .      .  .###########  #######
#          #  ......   .#                . #
#   ..     # .   .......#          ....... #
#   ######## . #############               #
#          # . # .             .......     #
#   ..     # . # ..........                #
#          # . #############               #
# ........................................ #
############################################